0000000000001100000000000000000
0000000000000111100000030000000
0000002222200000110000030000000
0000022222222000011000000000000
0000002222222200001000030000000
0000000222222222001000030000000
0000000022222222001000030000000
0000000002222200011111000000000
0000000000000000110001000000000
1111111111111111111111111111111
0000000000000000000000000000000
0000000000000000000000000000000
0000000000000000000000000000000
0000000000000000000000000000000
0000000000000000000000000000000
0000000000000000000000000000000
0000000000000000000000000000000
0000000000000000000000000000000
0000000000000000000000000000000
0000000000000000000000000000000
0000000000000000000000000000000
0000000000000000000000000000000
0000000000000000000000000000000
0000000000000000000000000000000
0000000000000000000000000000000
0000000000000000000000000000000
0000000000000000000000000000000
0000000000000000000000000000000
0000000000000000000000000000000
0000000000000000000000000000000
0000000000000000000000000000000
0000000000000000000000000000000